XXXXXX___XXXXXXXXXXXXXRRRRRXXXXXXXXXXX
X___XX___XXX__________RRRRR__________X
X__PP+PPPPPPPPPPPPPP+_RRRRR__________X
X__PPPPPPPPPPP+PPPPPP_RRRRR__________X
X_________XXXXXXXXXPP_RRR*R__________X
X_________________XPP_RRRRR__________X
X_________XXX_____XPP_RRRRR__________X
X___________X_____XPP_RRRRR__________X
X___________X_____XPP_RRRRR____s_____X
X___________X_____XPP_RRRRR__________X
____________XXX__XX+P_RRRRR__________X
X_______PPPPPP+PPPPPP_RRR*R__________X
X_______P+PPPPPPPPPPP_RRRRR__________X
________X_____________RRRRR__________X
________X_____________RRRRR__________X
X_______X_____________RRRRR___XXXXXXXX
X_______XXXXX_________RRRRR___X______X
X_______________r_____*RRRR___X______X
X_____________________RRRRR__________X
XXXXXXXXXXXXXXXXXXXXXXRRRRRXXXXXXXXXXX