XXXXXX___XXXXXXXXXXXXXXXXXXXXXXXXXXXXX
X___XX___XXX_________________________X
X____________________________________X
X____________________________________X
X_________XXXXXXXXX__________________X
X_________________X__________________X
X_________XXX_____X__________________X
X___________X_____X__________________X
X___________X_____X__________________X
X___________X_____X__________________X
____________XXX__XX__________________X
X____________________________________X
X____________________________________X
________X____________________________X
________X____________________________X
X_______X__________________XXXXXXXXXXX
X_______XXXXX______________X_________X
X____________________________________X
X____________________________________X
XXXXXXXXXXXXXXXXXXXXXXXXXXXXXXXXXXXXXX