XXXXXX___XXXXXXXXXXXXXRRRRRXXXXXXXXXXX
X_________XXXXX_______RRRRRPP________X
X__PP+PPPPPPPPPPPPPP+PRRRRRPP________X
X__PPPPPPPPPPP+PPPPPPPRRRRRPP________X
X__________________PPPRR*RRPP________X
X__________________PPPPPPPPPP________X
X__________________PPPPPPPPPP________X
X__________________PPPRRRRR__________X
X________XXXXX_____PPPRRRRR____s_____X
X________XXXXX_____PPPRRRRR__________X
_________XXXXX_____+PPRRRRR__________X
X_____PPPPPPPP+PPPPPPPRRR*R__________X
X_____PPP+PPPPPPPPPPPPRRRRR__________X
____PPPPXXXXX_________RRRRR__________X
____PPPPXXXXX_________RRRRR__________X
X___XXXXXXXXX_________RRRRR__________X
X___XXXXXXXXX_________RRRRR__________X
X_______________r_____*RRRR__________X
X_____________________RRRRR__________X
XXXXXX___XXXXXXXXXXXXXRRRRRXXXXXXXXXXX