XXXXXX___XXXXXXXXXXXXXRRRRRXXXXXXXXXXX
X_________XXXXX_______RRRRRPP________X
X__PPPPP+PPPPPPPPPPPPPRRRRRPP________X
X__PPPPPPPPPPPPPPPPPPPRRRRRPP________X
X____XXXXX_________PPPRR*RRPP________X
X____XXXXX_________PPPPPPPPPP________X
X____XXXXX_________PPPPPPPPPP________X
X__________________P+PRRRRR__________X
X________XXXXX_____PPPRRRRR____s_____X
X________XXXXX_____PPPRRRRR__________X
_________XXXXX_____PPPRRRRR__________X
X_____PPPPPPPPPPP+PPPPRRR*R__________X
X_____PPPPPPPPPPPPPPPPRRRRR__________X
____PPPPXXXXX_________RRRRR__________X
____PPPPXXXXX_________RRRRR__________X
X___XXXXXXXXX_________RRRRR__________X
X___XXXXXXXXX_________RRRRR__________X
X_______________r_____*RRRR__________X
X_____________________RRRRR__________X
XXXXXX___XXXXXXXXXXXXXRRRRRXXXXXXXXXXX